EA    ./src/textures/east.xpm
S    ./src/textures/barral.xpm
   R    1024      768
   NO      ./src/textures/north.xpm
SO ./src/textures/south.xpm
WE ./src/textures/west.xpm
  F      0,  0,   0
  C      255  ,   255,    255
1111111
10000221
1000221
10W0221
1000001
1010001
1111111