R    700     500
NO ./src/textures/north.xpm
SO ./src/textures/south.xpm
WE ./src/textures/west.xpm
EA ./src/textures/east.xpm
S ./src/textures/barral.xpm
F 220,100,0
C 250,30,20
        111111111111111111111111111111
        100000000011000000000000000001
        101100000111000000200000111111
        100100000000000000000011
111111111011000001110000000000001
100000000011000001110111111111111
11110111111111011100000010001
11110111111111011101010010001
1100000011010101110000000001
11111111111111011111111111111
11111111111111W1111111111111
1000200000000000222000100011      11111
10000000000000001101000010001     1101
110000011101010111110111100111   111111
11110111 1110101101111010001
11111111 11111111111111111111
